0000000000000000000000000
0111111111111111111111110
0111111111111111111111110
0000000000011111111111110
0111111111111111000000000
0111111111111111111111110
0111111111100001111111110
0111211111001100111111110
0111111111111111111111120
0111111111111111111000000
0111211111111111110011110
0111111000000011111111110
0111111111111111111111110
0111211111111111000000000
0111111111111111111111110
0111111100000001111111110
0111211111111100111111120
0111111111111111111100000
0111111111111111111111110
0111211111100000001111110
0111111111111111111111110
0111111111111111111111110
0000000000111111111111110
0111111111111111111111120
0000000000000000000000000
